.........##.#......##
..##.....#..#........
...H#....##.#...##...
..##............#$...
..........#.#...##...
....#.....#.#........
..#.........#........
............#........
