H........##.#......##
.........#..#........
....#....##.#........
...#.............$...
..........#.#........
....#.....#.#........
..#.........#........
............#........
